12 16
XXeXXXXX#######X
X      X       #
X    X         #
X  X           #
#              #
# XXX XX       #
#      XXX XXXXX
#        X     #
#        XXX   #
#              #
#              #
X##############X

B 1
I 4
F 3
